28
50
00000000008880000000000000000088811111188800000000
00030060008880000000600000000088811111188800000000
60000020008880504000200000006688888888888800000000
20330000008880000000000600062288888888888800000600
88888888888880000000030200020088888888888800000200
88888888888880503000000000300088800006088800000000
88888888888880000000600003600688800502088800000000
00000000008880400600200600260288800000088800000000
11111100008880000200000200020088800600088800000000
11111100008880030000000000000088830200088800000000
00001100048880005550000003000688800300088800000000
00001100008888888888880000000288806000088800000000
00001100008888888888886003000088802006088806000111
00001106008888888888882630600088800002088802000111
00001102004060030308880260260688806000088800000110
00001100000020000008880020020288802040088800000110
00001100000000000008888888888888888888888888000110
00001100000000000008888888888888888888888888000110
00001100006000000008888888888888888888888888001110
00001100002000000068880000000000000000000000001110
00001100000006000028884000000004000000000000001100
05001100000602000068880000000600000060000000001100
00001105000200000028880000000200004020000000001100
00001100000000000638885000300000000000000000001100
00001105000000000238885000000000060000000000001100
00001100000000000038887000006030020000003000001105
00001105000000000008880000002000000040000000001100
00001100000000000008880000000000000000000000001100