28
50
66666666222222222222266008880222222222222000000000
22222222000606666666622008888888888888888888888888
88000000000202222222200008888888888888888888888888
88000000000000000000000008888888888888888888888888
88000000008888888888888888880000000000088830060000
88000000008888888888888888880000000000088800020060
88000000008888888888888888880000000000088800000020
88000000008884000000000008880000000000088804000000
88888888888880000000000008880000000000088804000000
88888888888880011111111008880000000000088800006003
88888888888886011111111038880000000000088800002000
00000400008882011111111008880000000000088806000000
00000000008886011111111008880000000000088802000000
00060003008882011111111008880000000000088800060000
30020000008880011110000008880000000000088806020600
00000600008886011110000008880000000000088802040200
00306203008882011110050038880000000000088800000600
00002000008880011110500008880000000000088800600200
00000000008880000000003008880000000000088830200000
88888888888888888888888888888888888888888800060000
88888888888888888888888888888888888888888800020000
88888888888888888888888888888888888888888860300060
00000000008880110000000500050688800000188820000020
00000000008880111000000600000288803300188800064000
00005040008880111006000200000688833000188830020000
00000000058887111002000000000288800111188800000060
00000000008880000000000000000088811111188800000020
00000000008880000000000000000088811111188800000000